22
****************************************
*......................................*
*......................................*
*......................................*
*......................................*
*......................................*
*.................*....................*
*.................*....................*
*.................*....................*
*.................*....................*
*.................*....................*
*.................*....................*
*.................*....................*
*.................*....................*
*......................................*
*......................................*
*......................................*
*......................................*
*......................................*
*......................................*
*......................................*
****************************************