22
****************************************
*......................................*
*......................................*
*.........****************.............*
*......................................*
*......................................*
*.....*...........*..........*.........*
*.....*...........*..........*.........*
*.....*...........*..........*.........*
*.....*...........*..........*.........*
*.....*...........*..........*.........*
*.....*...........*..........*.........*
*.....*...........*..........*.........*
*.....*...........*..........*.........*
*......................................*
*......................................*
*..........****************............*
*......................................*
*......................................*
*......************************........*
*......................................*
****************************************